tileset:
0=dirt
1=grass
2=tree

map:
2111111111
1100000100
0001000000
0000000000
0000110000
0100000000
1000000000
1110001000
2100000000
1110000000
