tileset:
0=dirt
1=grass

map:
1111111111
0000000100
0001000000
0000000000
0000010000
0100000000
0000000000
0010001000
0100000000
0000000000
