tileset:
0=dirt
1=grass
2=tree

map:
1,1,1,1,1,1,1,1,1,2
1,1,0,0,0,0,0,1,1,1
0,0,0,1,0,0,0,0,1,0
0,0,0,0,0,0,0,0,0,0
0,0,0,0,1,1,0,0,0,0
0,1,0,0,0,0,0,0,0,0
1,0,0,0,0,0,0,0,0,0
1,1,1,0,0,0,1,1,1,1
0,1,0,0,0,0,1,1,2,1
1,2,1,0,0,0,0,1,1,1
