tileset:
0=dirt
1=grass
2=tree

map:
1111111112
1100000111
0001000010
0000000000
0000110000
0100000000
1000000000
1110001111
0100001121
1210000111
